+---+---+---+---+---+---+---+---+
| S * *             |           |
+---+ * +---+   +   +   +---+   +
|   | * * * |   |   |       |   |
+   +---+ * +   +   +   +---+   +
| * * * * * |   |       |       |
+ * +---+---+---+---+   +   +---+
| * | * * * * * * * |   |       |
+ * + * +---+---+ * +   +---+   +
| * * * |       | * |       |   |
+---+---+   +   + * +---+---+   +
|   |       |   | * * * |       |
+   +   +   +---+---+ * +---+   +
|   |   |             E |       |
+   +   +---+   +---+---+   +---+
|           |                   |
+---+---+---+---+---+---+---+---+
